[openstack.allocation.v1]
allocation amend = nectarallocationclient.osc.v1.allocations:AmendAllocation
allocation approve = nectarallocationclient.osc.v1.allocations:ApproveAllocation
allocation bundle list = nectarallocationclient.osc.v1.bundles:ListBundles
allocation bundle quotas = nectarallocationclient.osc.v1.bundles:ShowBundleQuotas
allocation bundle show = nectarallocationclient.osc.v1.bundles:ShowBundle
allocation create = nectarallocationclient.osc.v1.allocations:CreateAllocation
allocation delete = nectarallocationclient.osc.v1.allocations:DeleteAllocation
allocation facility list = nectarallocationclient.osc.v1.facilities:ListFacilities
allocation facility show = nectarallocationclient.osc.v1.facilities:ShowFacility
allocation grant list = nectarallocationclient.osc.v1.grants:ListGrants
allocation grant show = nectarallocationclient.osc.v1.grants:ShowGrant
allocation history = nectarallocationclient.osc.v1.allocations:AllocationHistory
allocation list = nectarallocationclient.osc.v1.allocations:ListAllocations
allocation organisation approve = nectarallocationclient.osc.v1.organisations:ApproveOrganisation
allocation organisation create = nectarallocationclient.osc.v1.organisations:CreateOrganisation
allocation organisation decline = nectarallocationclient.osc.v1.organisations:DeclineOrganisation
allocation organisation list = nectarallocationclient.osc.v1.organisations:ListOrganisations
allocation organisation show = nectarallocationclient.osc.v1.organisations:ShowOrganisation
allocation quota history = nectarallocationclient.osc.v1.quotas:QuotaHistory
allocation quota list = nectarallocationclient.osc.v1.quotas:ListQuotas
allocation resource list = nectarallocationclient.osc.v1.resources:ListResources
allocation resource show = nectarallocationclient.osc.v1.resources:ShowResource
allocation service-type list = nectarallocationclient.osc.v1.service_types:ListServiceTypes
allocation service-type show = nectarallocationclient.osc.v1.service_types:ShowServiceType
allocation set = nectarallocationclient.osc.v1.allocations:UpdateAllocation
allocation show = nectarallocationclient.osc.v1.allocations:ShowAllocation
allocation site list = nectarallocationclient.osc.v1.sites:ListSites
allocation site show = nectarallocationclient.osc.v1.sites:ShowSite
allocation zone compute-homes = nectarallocationclient.osc.v1.zones:ListComputeHomes
allocation zone list = nectarallocationclient.osc.v1.zones:ListZones
allocation zone show = nectarallocationclient.osc.v1.zones:ShowZone

[openstack.cli.extension]
allocation = nectarallocationclient.osc.plugin
